5,17,17,17,17,5,17,17,5,17,5,17,5,5,5,5,17,17,17,17,17,17,5,17,17,5,5,17,5,5,5,5,5,5,17,17,17,5,5,5,17,5,5,5,17,5,6,6,6,8,8,8,8,8,8,8,8,24,24,8,8,8,8,8,8,8,8,8,8,8,8,8,8,8,8,8,8,8,8,8
5,17,5,17,5,17,5,5,5,17,17,5,5,17,5,17,5,5,17,5,17,5,5,17,17,17,17,17,17,17,5,5,5,5,5,5,17,17,5,5,5,17,17,5,5,6,6,8,8,8,8,8,8,8,8,8,24,24,8,8,8,8,8,8,8,8,8,8,8,8,8,8,8,8,8,8,8,8,8,8
5,17,17,17,17,5,5,5,5,17,5,5,5,17,5,5,5,17,5,17,5,5,17,5,17,5,17,5,5,5,17,5,5,5,17,5,17,5,17,17,5,5,5,17,5,6,8,8,8,8,8,8,8,8,8,8,8,24,24,8,8,8,8,8,8,8,8,8,8,8,6,6,6,6,6,6,6,8,8,8
17,17,17,5,17,5,5,5,5,17,5,17,17,17,17,5,5,5,17,5,5,17,17,5,17,17,17,17,17,5,17,5,5,17,17,5,5,17,5,17,17,17,5,5,5,6,8,8,8,8,8,8,8,8,8,8,8,8,24,24,24,8,8,8,8,8,8,8,8,6,6,8,8,8,8,8,8,6,8,8
5,17,5,17,5,17,5,5,5,5,17,17,17,17,5,5,17,17,5,5,5,5,17,17,5,5,17,5,5,17,17,17,5,5,5,17,17,5,17,5,17,17,5,5,5,6,8,8,8,8,8,8,8,8,8,8,8,8,24,8,8,8,8,8,8,8,8,8,8,6,8,8,8,8,8,8,8,6,8,8
5,5,17,17,17,17,5,17,17,5,5,5,17,5,5,5,17,5,5,5,5,5,5,5,5,17,17,17,5,17,17,5,5,5,17,5,17,5,17,17,5,5,17,17,5,6,8,8,8,8,8,8,8,8,8,8,8,8,8,8,8,8,8,8,8,8,8,8,8,6,8,8,8,8,8,8,8,6,8,8
17,5,17,17,17,5,17,5,17,5,5,17,5,5,5,17,5,17,5,5,5,17,17,5,17,5,17,17,5,5,5,17,17,5,17,5,5,5,17,17,17,5,17,5,17,6,8,8,8,8,8,8,8,8,8,8,8,8,8,8,8,8,8,8,8,8,8,8,8,6,8,8,8,8,8,8,8,6,8,8
5,17,17,17,17,5,5,5,5,5,17,17,17,5,17,17,5,17,17,5,17,5,17,5,17,17,5,17,5,5,17,5,17,5,5,17,17,5,5,5,17,5,17,5,5,6,24,24,24,8,8,8,8,8,8,8,8,8,8,8,8,8,8,8,8,8,8,8,8,6,6,8,8,8,8,8,8,6,8,8
5,5,17,5,5,17,5,17,5,5,5,17,5,5,5,5,17,5,17,17,17,5,5,17,5,17,5,5,17,5,17,17,17,17,17,17,17,5,5,5,17,5,17,17,17,6,24,24,8,8,8,8,8,8,8,8,8,8,8,8,8,8,8,8,8,8,8,8,8,24,6,6,6,6,6,6,6,8,8,8
5,5,17,17,5,5,17,5,17,5,5,17,17,5,5,5,5,5,5,17,5,17,17,5,17,5,17,17,17,5,17,17,17,17,17,5,17,17,5,5,17,17,5,5,5,6,24,24,8,8,8,8,8,8,24,8,8,8,8,8,8,8,8,8,8,8,8,24,24,24,8,8,8,8,8,8,8,8,8,8
17,5,5,5,17,5,5,17,17,17,5,5,17,5,17,17,5,17,5,17,17,17,5,5,17,5,17,5,17,5,5,17,5,5,5,17,17,5,5,17,17,17,5,17,5,6,24,24,24,8,24,24,24,24,24,8,8,8,24,8,8,8,8,8,8,8,8,8,24,8,8,8,8,8,8,8,8,8,8,8
17,5,5,5,17,5,5,5,5,5,5,17,5,5,5,17,5,17,17,17,17,17,17,17,17,17,17,17,17,17,17,5,17,17,17,5,5,17,5,17,17,17,17,5,17,6,8,24,24,24,24,24,24,8,8,24,24,8,24,24,8,8,8,8,8,24,24,24,24,24,8,8,8,8,8,8,8,8,8,8
5,17,17,5,17,17,5,5,17,17,5,17,5,5,17,5,17,17,17,5,17,5,5,5,17,17,17,17,5,5,17,5,5,5,5,5,5,17,17,5,5,5,17,5,17,6,8,24,24,24,24,24,24,24,24,24,24,24,24,8,8,8,8,8,8,8,24,24,24,24,8,8,8,8,8,8,8,8,8,8
17,17,17,5,17,5,17,17,5,5,5,17,5,17,5,5,17,17,5,17,5,5,17,5,5,17,5,17,17,17,39,17,5,5,5,5,17,5,17,5,17,5,5,5,5,6,24,24,8,24,24,24,24,8,8,24,24,24,24,8,8,8,8,8,8,8,24,24,24,24,8,8,8,8,8,8,8,8,8,8
5,5,5,17,17,5,17,17,17,17,5,17,5,5,17,5,17,5,5,17,5,17,5,17,17,5,17,17,39,17,39,39,17,17,17,17,39,17,5,5,17,17,5,17,17,6,8,8,8,8,8,24,24,8,24,24,24,8,8,8,8,8,24,24,8,24,24,24,24,8,8,8,8,8,8,8,8,8,8,8
5,17,5,5,17,17,17,5,5,5,17,17,5,5,17,17,5,17,5,5,5,5,5,17,5,5,17,17,39,39,39,39,17,5,17,39,39,17,17,17,5,5,17,5,5,6,8,8,8,8,8,8,8,8,8,24,8,8,8,8,8,24,24,24,24,24,24,24,24,24,8,8,8,8,8,8,8,8,8,8
17,5,5,17,5,17,17,5,5,17,5,5,17,17,17,5,17,17,17,17,17,5,17,17,17,17,39,17,17,17,17,39,17,17,39,39,39,39,17,17,5,5,17,5,17,6,8,8,8,8,8,8,8,8,8,8,8,8,8,8,8,8,8,8,8,8,8,8,24,8,8,8,8,8,8,8,8,8,8,8
5,5,17,5,17,17,17,5,5,5,17,5,17,5,5,5,17,5,5,17,17,5,5,5,17,17,39,17,17,39,39,39,17,39,39,17,39,17,17,17,17,5,17,17,5,6,8,8,8,8,8,8,8,8,8,8,8,8,8,8,8,8,8,8,8,8,8,8,24,8,8,8,8,8,8,8,8,8,8,8
17,17,5,17,5,5,5,5,17,17,17,5,17,17,17,17,17,5,5,17,17,17,5,17,5,17,39,39,17,39,17,17,17,17,17,39,39,39,39,17,17,17,39,39,17,6,8,8,8,8,8,8,8,8,8,8,8,8,8,8,8,8,8,8,8,8,8,8,8,8,8,8,8,8,8,8,8,8,8,8
17,17,17,17,17,17,5,17,5,5,5,17,17,17,17,17,5,5,5,17,5,17,5,17,17,17,17,39,39,39,17,39,39,39,39,39,39,39,17,17,39,17,39,39,6,6,8,8,8,8,8,8,8,8,8,8,8,8,8,8,8,8,8,8,8,8,8,8,8,8,8,8,8,8,8,8,8,8,8,8
17,17,5,17,5,17,5,17,5,5,5,17,17,17,17,5,5,5,17,17,5,17,17,17,17,39,39,39,39,39,39,39,17,39,39,17,39,17,39,39,39,39,39,17,6,8,8,8,8,8,8,8,8,8,8,8,8,8,8,8,8,8,8,8,8,8,8,8,8,8,8,8,8,8,8,8,8,8,8,8
17,5,5,17,5,5,17,17,17,5,5,17,17,17,5,17,17,17,5,5,17,5,5,5,17,17,17,39,17,39,39,39,39,39,17,39,39,17,39,39,39,17,17,5,6,8,8,8,8,8,8,8,8,8,8,8,8,8,8,8,8,8,8,8,8,8,24,24,24,8,8,8,8,8,8,8,8,8,8,8
17,5,5,5,5,5,17,5,17,5,17,5,17,17,17,5,17,17,5,17,17,17,17,17,17,17,5,17,17,17,39,17,39,17,39,39,17,39,39,17,17,17,17,5,6,8,8,8,8,8,8,8,8,8,8,8,8,8,8,8,8,8,8,8,8,8,8,24,24,8,8,8,8,8,8,8,8,8,24,8
17,5,17,5,5,5,17,5,17,5,5,5,5,17,17,17,17,17,5,5,5,17,5,5,17,17,5,5,17,5,17,5,17,17,39,39,39,39,39,39,39,39,17,17,6,8,8,8,8,8,8,8,8,8,8,8,8,8,8,8,8,8,8,24,24,24,24,24,24,8,8,8,8,8,8,8,8,24,24,8
5,5,17,5,5,17,5,17,5,5,5,17,5,17,5,5,5,17,17,5,5,5,5,17,5,5,5,17,17,17,5,5,17,5,17,17,39,39,39,17,17,17,17,6,6,8,8,8,8,8,8,8,8,8,8,8,8,8,8,8,8,8,8,24,24,24,24,24,24,8,8,8,8,8,8,24,24,24,8,8
5,5,17,17,5,17,17,17,5,17,5,17,5,5,5,17,18,16,17,5,5,5,17,17,17,5,5,5,5,5,17,5,5,17,17,39,17,39,39,39,17,17,5,6,8,8,8,8,8,8,8,8,8,8,8,8,8,8,8,8,8,8,8,8,8,24,24,8,8,8,8,8,8,8,8,24,8,24,24,8
17,5,5,5,17,17,5,5,5,17,17,17,5,17,17,17,18,16,17,17,17,17,5,5,17,17,17,5,5,17,5,17,17,17,39,39,17,39,39,17,17,17,5,6,8,8,8,8,8,8,8,8,8,8,8,8,8,8,8,8,8,8,8,8,8,24,8,8,8,8,8,8,8,8,8,8,8,24,24,24
5,5,17,17,17,17,17,5,17,17,17,17,17,5,17,5,18,16,5,17,5,5,5,5,17,17,5,17,5,17,17,17,17,5,17,39,39,39,39,39,17,17,5,6,8,8,8,8,8,8,8,8,8,8,8,8,8,8,24,24,8,8,8,8,8,8,8,8,8,24,24,8,8,8,8,8,8,24,8,24
17,5,17,5,5,5,17,17,5,5,17,5,17,17,17,17,18,32,19,17,17,17,17,17,5,5,5,17,17,17,17,5,5,17,17,39,39,39,39,17,17,17,6,6,8,24,8,8,8,8,8,8,8,8,8,8,8,8,24,24,8,8,8,8,8,8,8,8,8,24,24,24,8,8,8,8,8,8,24,24
5,5,17,17,17,17,5,5,17,17,5,5,17,5,17,5,4,2,16,17,5,5,5,5,17,17,17,17,17,17,5,5,17,17,39,39,17,17,39,39,39,39,6,24,24,24,24,24,8,24,24,24,8,8,8,24,8,24,8,24,24,8,8,8,8,8,8,8,8,24,24,24,24,8,8,8,8,24,24,8
17,5,17,5,17,5,5,5,5,5,5,17,17,5,17,5,5,18,16,17,5,5,5,17,5,17,5,17,17,5,5,5,5,5,17,17,5,17,39,39,17,39,6,8,8,8,8,24,24,8,24,8,8,8,24,24,24,24,8,24,8,8,8,8,8,8,8,8,8,24,24,24,24,24,24,24,8,8,24,24
17,17,5,17,5,5,17,5,17,5,17,5,5,5,17,5,17,18,16,17,5,17,17,5,5,5,5,5,17,5,17,5,17,5,17,5,5,17,39,17,5,6,6,24,24,8,8,8,24,24,24,8,8,8,24,24,24,24,24,24,8,8,8,8,8,8,8,8,8,24,24,24,24,24,24,8,8,8,8,8
5,5,17,5,5,17,17,17,17,17,5,17,5,5,5,17,17,18,16,17,17,17,5,17,5,5,5,5,17,17,5,5,17,17,17,5,5,17,17,5,5,6,24,24,24,24,24,8,24,8,24,8,8,8,8,8,24,24,8,8,8,8,8,8,8,8,8,8,8,8,24,24,24,24,24,8,8,8,8,8
17,5,17,5,17,17,17,39,39,39,17,39,17,17,5,17,17,18,32,19,17,5,17,5,17,17,5,17,5,17,17,5,5,17,17,17,5,5,5,5,6,6,24,24,24,24,24,24,24,8,24,8,8,8,8,24,24,24,8,8,8,8,8,8,8,8,8,8,8,24,24,24,24,24,8,8,8,8,8,8
5,17,5,17,39,39,39,39,39,17,17,39,17,17,5,17,17,4,2,16,17,17,17,17,17,17,17,17,5,17,17,17,17,17,5,17,17,17,6,6,6,24,24,8,24,8,8,24,8,8,24,8,8,8,8,8,24,24,8,8,8,8,8,8,8,8,8,8,8,8,8,24,24,8,8,8,8,8,8,8
17,17,17,39,39,39,39,39,17,39,39,39,17,39,17,5,17,17,18,16,5,17,17,17,17,17,5,5,5,5,17,5,5,5,17,17,17,17,6,8,24,24,8,24,24,24,8,8,8,8,8,8,8,8,8,8,8,8,8,8,8,8,8,8,8,8,8,8,8,8,8,8,8,8,8,8,8,8,8,8
5,17,39,39,39,39,17,17,17,17,39,17,39,39,17,17,39,17,18,16,5,17,17,17,17,17,17,17,17,17,17,17,5,5,17,5,17,6,6,8,8,8,24,24,8,24,24,8,8,8,8,8,8,8,8,8,8,8,8,8,8,8,8,8,8,8,8,8,8,8,8,8,8,8,8,8,8,8,8,8
17,5,17,17,39,17,39,39,39,39,39,17,17,39,17,17,39,17,18,16,17,17,5,5,17,17,17,5,17,17,5,17,17,5,17,5,5,6,8,8,8,8,24,24,8,24,8,8,8,8,8,8,8,8,24,8,8,8,8,8,8,8,8,8,8,8,8,8,8,8,8,8,8,8,8,8,8,8,8,8
17,5,17,17,39,39,39,39,39,39,39,39,39,39,39,39,39,17,18,32,19,17,5,5,5,17,5,5,5,5,17,17,17,17,5,17,17,6,8,8,8,8,8,24,24,24,8,8,8,8,8,24,24,8,24,8,8,8,8,8,8,8,8,8,8,8,8,8,24,8,8,8,8,8,8,8,8,8,8,8
17,17,5,17,17,39,39,17,17,39,17,17,17,39,39,17,17,5,4,2,16,5,17,17,17,5,17,5,5,5,17,5,5,17,5,5,17,6,8,8,8,8,8,8,8,8,8,8,8,24,24,24,24,24,24,24,8,24,24,8,8,8,8,8,8,8,8,24,24,8,8,8,8,8,8,8,8,8,8,8
5,17,5,5,17,39,39,39,39,17,39,17,17,39,39,17,17,17,17,18,16,5,17,17,17,17,5,17,17,17,5,5,5,5,17,17,17,6,8,8,8,8,8,8,8,8,8,8,8,8,8,24,24,24,24,24,24,24,8,8,8,8,8,8,8,24,24,24,24,8,8,8,8,8,8,8,8,8,8,8
17,17,5,17,39,39,39,39,17,39,39,17,39,39,39,39,39,17,17,18,16,17,17,5,17,5,17,17,17,5,5,17,17,17,17,5,5,6,8,8,8,8,8,8,8,8,8,8,8,8,24,24,24,24,24,24,24,24,8,8,8,8,8,8,8,8,24,24,24,24,8,8,8,8,8,8,8,8,8,8
17,17,5,17,39,17,17,39,39,39,17,17,39,39,17,39,17,17,17,18,16,17,17,5,17,5,5,17,17,5,5,17,17,17,17,5,5,6,8,8,8,8,8,8,8,8,8,8,8,8,24,24,24,24,24,24,24,24,24,8,8,8,8,8,8,8,24,24,8,8,8,8,8,8,8,8,8,8,8,8
17,17,17,17,17,39,39,39,17,39,17,5,17,17,39,39,17,5,17,18,16,5,5,17,5,5,5,5,17,5,17,5,17,17,17,5,5,6,8,8,8,8,8,8,8,8,8,8,8,24,24,24,24,24,24,24,24,24,24,8,8,8,8,8,8,8,8,8,8,8,8,8,8,8,8,8,8,8,8,8
17,17,5,17,5,17,39,17,39,39,17,17,17,17,39,39,39,17,17,18,32,19,17,5,5,5,17,17,17,5,17,5,17,5,17,17,5,17,6,8,8,8,8,8,8,8,8,8,8,24,24,24,8,24,24,24,8,24,24,8,8,8,8,8,8,8,8,8,8,8,8,8,8,8,8,8,8,8,8,8
5,17,17,5,17,39,39,17,39,17,17,5,17,5,17,17,39,17,17,4,2,16,5,5,5,5,5,17,17,17,5,17,17,17,5,5,17,5,6,6,8,8,8,8,8,8,8,8,8,8,24,8,8,8,8,8,8,8,8,8,8,8,8,8,8,8,8,8,8,8,8,8,8,8,8,8,8,8,8,8
17,17,5,17,5,17,39,17,17,17,17,5,5,5,5,17,39,17,17,17,18,16,17,5,17,5,17,5,5,5,5,5,5,5,17,5,17,5,5,6,6,8,8,8,8,8,8,8,8,8,8,8,8,8,8,8,8,8,8,8,8,8,8,8,8,8,8,8,8,8,8,8,8,8,8,8,8,8,8,8
17,17,5,5,17,5,17,5,17,5,17,17,5,5,17,39,39,39,39,17,18,16,5,17,5,5,17,17,17,17,17,17,5,5,17,5,5,5,17,17,6,6,8,8,8,8,8,8,8,8,8,8,8,8,8,8,8,8,8,8,8,8,8,8,8,8,8,8,8,8,8,8,8,8,8,8,8,8,8,8
5,5,5,5,17,5,17,17,17,17,17,17,17,17,5,17,39,39,17,17,18,16,5,17,5,5,17,17,17,17,17,5,17,17,17,17,17,5,17,17,17,6,6,6,6,6,8,8,8,8,8,8,8,8,8,8,8,8,8,8,8,8,8,8,8,8,8,8,8,8,8,8,8,8,8,8,8,8,8,8
17,17,17,5,17,17,5,17,17,5,5,17,5,5,17,39,39,17,17,5,18,16,17,5,17,5,17,17,17,17,17,17,5,17,17,5,17,17,5,5,17,5,5,17,17,6,6,6,6,6,6,6,6,6,6,6,6,6,8,8,8,8,8,8,8,17,8,8,8,8,8,8,17,5,17,8,8,8,8,8
17,5,5,17,5,17,17,17,17,17,5,17,5,17,17,17,17,5,17,17,18,32,19,5,17,5,17,5,5,5,17,17,17,5,17,5,5,17,17,17,7,17,5,5,17,5,17,17,17,17,5,17,17,17,5,17,6,6,6,6,6,6,8,8,8,17,17,8,8,8,17,8,17,17,5,17,17,8,8,8
17,17,17,17,17,5,5,5,5,5,17,5,17,17,5,5,17,5,5,17,4,2,16,17,5,5,17,17,5,5,17,17,5,17,5,17,17,5,17,17,7,17,17,17,17,5,5,5,17,5,5,5,17,5,5,17,17,5,17,5,6,6,6,17,17,5,17,17,8,17,5,17,17,17,5,17,5,17,8,8
17,17,5,17,17,17,5,5,5,5,5,17,17,5,17,5,5,17,5,5,17,18,16,17,5,5,17,17,5,17,17,17,5,17,5,17,5,5,17,7,7,17,7,17,17,5,17,5,17,5,17,5,5,17,17,17,7,17,5,17,5,5,17,17,17,17,5,5,17,5,17,5,17,17,17,5,5,17,8,17
17,17,5,5,17,17,5,17,17,5,5,5,17,17,17,17,5,5,5,17,17,18,16,5,17,5,17,5,17,17,17,17,5,17,17,17,17,17,17,7,17,7,7,17,17,17,17,5,5,5,17,17,5,17,17,7,7,17,17,17,17,5,17,5,5,5,17,5,5,5,17,17,6,6,6,6,6,6,6,6
5,17,17,5,17,17,17,5,5,5,5,5,17,17,5,5,17,5,5,5,17,18,16,5,5,5,17,17,17,17,17,17,17,17,5,17,17,17,7,7,7,7,7,17,17,5,5,5,17,17,17,7,17,17,17,7,7,7,17,17,17,5,17,5,17,17,17,17,5,5,6,6,6,5,17,17,17,5,17,5
5,5,17,17,5,17,17,5,17,5,17,17,17,17,5,5,5,17,17,5,5,18,16,17,17,17,17,5,17,5,17,5,17,5,17,17,5,17,17,17,7,17,7,17,17,17,5,17,17,7,7,7,7,7,17,17,7,17,5,17,5,5,17,5,17,5,17,5,5,6,6,5,5,5,5,17,5,5,5,5
17,5,5,5,17,17,5,5,17,17,17,17,17,17,5,17,17,17,17,5,5,18,16,5,17,5,5,17,5,17,5,5,17,17,5,5,5,17,7,7,7,7,17,17,17,17,17,17,17,17,7,7,7,7,7,7,7,17,17,5,5,17,5,5,17,5,5,17,6,6,17,17,5,17,17,6,6,6,6,6
17,17,17,17,17,17,17,17,5,5,5,5,17,17,5,17,5,5,17,17,17,18,32,19,17,5,17,17,5,17,5,5,5,5,5,5,17,17,17,7,7,7,17,7,17,5,5,5,5,17,7,17,7,7,17,17,7,17,5,17,5,5,5,17,5,5,17,17,6,17,17,5,17,17,6,6,5,17,5,17
17,17,17,5,17,17,17,5,5,17,5,17,5,17,17,17,5,5,17,17,17,4,2,32,33,33,19,17,5,17,17,17,5,5,5,17,17,5,17,7,17,7,7,7,17,17,17,17,17,7,7,7,7,7,7,7,7,17,5,17,17,17,5,5,17,17,17,5,6,17,5,17,5,6,6,17,17,17,17,5
5,5,5,17,17,5,17,17,17,17,5,17,5,17,5,17,17,5,5,17,17,17,4,1,1,2,32,33,33,33,19,5,17,5,17,17,5,17,17,17,17,7,7,7,7,17,17,17,17,17,17,17,17,17,7,7,7,17,5,17,5,17,17,17,5,5,5,5,6,17,5,5,5,6,5,17,5,5,5,5
17,17,5,17,17,5,17,17,17,17,5,17,17,5,17,17,17,17,5,17,17,17,17,17,5,4,1,1,1,2,32,33,33,19,17,5,17,5,5,5,17,7,7,17,17,5,5,5,5,5,17,17,5,5,17,17,7,17,17,5,5,17,5,5,17,17,5,5,6,17,17,5,5,6,5,5,17,5,17,17
17,5,5,17,17,17,5,17,5,5,5,17,17,17,5,5,5,5,17,17,5,5,17,17,5,17,5,17,5,4,1,1,2,32,33,33,19,17,17,5,17,7,17,17,5,5,5,5,5,17,17,5,5,5,17,7,7,7,17,17,17,5,17,17,17,17,5,5,6,5,5,17,17,6,5,17,5,5,5,17
5,5,17,5,17,17,17,5,5,5,17,5,17,5,5,17,5,5,17,17,5,17,5,17,17,5,17,5,5,17,17,17,4,1,1,2,32,33,33,33,33,19,5,17,5,17,5,17,17,17,5,5,17,17,17,7,7,17,17,5,17,17,5,17,5,5,17,17,6,17,17,5,5,6,17,5,5,5,5,17
5,5,5,5,5,5,5,17,17,17,5,5,17,5,5,5,17,5,17,5,17,5,5,17,5,17,17,5,5,17,5,5,17,5,17,4,1,1,1,1,2,32,33,33,33,33,33,33,19,17,17,17,17,17,17,17,7,7,17,5,17,17,17,5,5,5,17,17,6,17,17,5,17,6,17,5,5,17,17,5
5,5,17,5,5,5,5,5,17,5,17,17,17,5,17,17,5,5,5,17,17,17,5,17,17,17,5,17,5,17,17,17,23,17,17,17,39,39,39,17,4,1,1,1,1,1,1,2,32,33,33,33,33,19,5,17,17,17,17,17,5,17,5,5,5,17,5,17,6,5,5,5,5,6,5,17,17,5,5,17
5,5,5,5,5,5,17,5,5,5,5,17,17,17,17,5,5,17,17,17,5,17,17,5,17,5,17,17,5,17,17,23,23,17,17,39,39,39,17,17,5,23,23,5,17,17,17,4,1,1,1,1,2,32,33,33,33,19,5,17,17,17,5,5,5,17,17,5,6,17,17,5,17,6,5,5,5,5,5,17
5,5,5,17,17,5,17,5,5,17,5,17,17,17,17,5,5,17,5,5,17,5,17,5,17,5,17,17,17,17,17,23,23,23,23,17,39,17,5,5,23,23,5,17,17,5,5,5,5,5,39,39,4,1,1,1,2,32,19,17,17,5,17,5,17,5,17,17,6,5,5,17,5,6,6,5,17,5,5,5
17,5,17,5,5,5,17,5,5,5,17,17,5,5,5,5,17,5,17,5,5,5,5,5,17,17,17,5,17,17,23,17,23,23,17,39,39,17,5,23,23,5,23,5,17,17,5,5,5,5,5,39,39,39,5,17,4,2,16,5,17,5,5,17,5,17,17,17,6,6,17,5,5,17,6,6,6,17,5,17
17,17,5,5,17,5,5,17,17,17,5,17,5,5,17,17,17,17,17,17,17,5,5,5,17,5,5,17,17,17,23,23,23,23,17,17,17,5,23,23,5,5,23,23,5,5,17,5,39,39,39,39,39,5,5,17,5,18,16,17,17,17,5,5,17,5,5,17,5,6,17,17,5,5,5,5,6,6,6,6
5,17,17,17,5,17,5,17,17,17,17,5,17,17,5,5,17,17,5,17,17,17,17,5,17,17,17,17,23,23,23,23,23,17,5,5,5,23,23,23,5,5,23,23,23,23,5,5,5,39,39,5,5,5,17,5,5,18,16,17,5,5,17,5,17,5,17,5,5,6,6,17,17,5,17,17,17,17,17,6
5,5,5,5,5,17,17,17,17,5,17,17,17,5,17,5,5,17,5,5,17,17,17,5,17,5,17,17,17,23,17,23,17,17,17,5,5,5,23,23,23,23,23,23,23,23,23,23,23,5,5,5,5,5,5,5,5,18,32,19,5,5,17,5,17,17,17,17,17,5,6,17,17,17,17,17,5,17,17,5
17,17,17,17,5,17,5,5,5,5,5,17,5,17,5,5,5,5,17,17,17,17,5,17,17,5,5,17,17,23,23,23,23,17,17,17,17,5,5,5,5,5,5,5,23,5,23,23,23,23,23,5,5,5,23,23,23,4,2,16,17,17,17,17,5,17,5,5,17,5,6,5,17,5,17,5,22,22,5,17
5,17,17,17,5,5,5,17,5,5,5,17,17,5,5,5,5,39,5,17,17,5,5,5,17,17,17,5,17,23,17,23,17,23,17,17,5,5,5,17,5,5,5,23,23,23,5,23,5,23,5,23,5,23,23,5,23,23,18,16,5,5,17,5,17,5,5,17,17,17,6,5,5,17,17,22,22,22,22,17
17,5,17,17,17,5,17,17,17,5,5,17,17,5,39,39,5,39,39,5,17,17,17,17,5,5,17,17,23,23,17,23,23,23,17,5,23,5,5,5,5,23,23,5,23,5,23,5,23,23,23,23,23,23,5,5,23,5,18,32,19,17,17,5,17,5,17,5,5,5,6,6,17,5,22,22,22,22,22,5
17,5,17,17,5,17,17,17,17,17,5,17,5,39,5,39,39,5,39,39,5,17,5,17,5,5,5,17,17,23,17,23,17,23,23,23,23,5,5,5,5,23,23,23,23,23,23,23,5,23,23,23,5,23,5,5,5,23,4,2,16,17,5,17,5,5,17,17,5,5,5,6,17,17,22,22,22,22,22,5
5,17,17,5,5,5,17,5,17,5,5,5,39,39,39,5,39,39,39,5,17,5,5,17,17,17,5,5,5,17,17,23,17,23,17,5,23,5,17,5,5,5,5,5,23,23,23,5,5,5,5,5,5,23,23,5,23,23,23,18,16,17,17,17,17,17,17,5,5,5,17,6,17,5,5,22,22,22,22,17
5,17,5,17,17,17,5,17,5,5,17,5,39,5,39,39,39,39,39,39,5,17,5,17,5,17,17,5,5,17,5,17,17,17,5,5,23,23,5,23,23,23,23,5,5,23,5,17,5,23,23,23,23,23,23,5,23,5,5,18,16,17,17,17,5,17,5,17,17,5,5,6,5,17,17,22,22,22,22,17
17,17,17,17,5,5,5,17,5,5,5,5,39,5,39,5,5,39,5,5,5,17,17,17,17,17,5,5,17,5,17,5,17,17,17,17,5,23,23,23,23,5,23,23,5,5,17,17,5,5,5,5,23,23,23,23,23,5,5,18,16,5,17,5,17,17,5,17,17,17,17,6,6,17,5,5,22,22,17,17
17,17,17,5,5,5,5,5,17,5,39,39,39,5,39,5,5,5,5,5,17,5,17,5,17,17,5,5,5,5,5,5,5,5,17,5,5,23,5,5,23,5,5,5,5,5,17,17,17,17,5,23,23,23,5,23,5,5,17,18,16,5,5,5,17,5,17,5,17,17,5,5,6,17,5,17,5,17,5,17
17,5,5,5,17,17,17,17,5,17,5,39,5,17,5,5,5,5,5,5,17,5,5,17,17,17,5,5,5,17,5,17,5,17,17,5,17,5,5,5,23,23,23,23,5,5,5,5,5,5,5,23,23,5,17,5,17,17,5,18,16,17,17,5,5,5,17,5,5,5,17,17,6,5,17,5,5,17,5,17
5,17,5,17,17,17,5,17,17,5,17,5,5,17,17,5,5,5,5,5,5,5,5,17,17,17,5,17,5,5,17,5,5,5,5,5,17,5,5,5,23,23,23,23,5,17,5,17,5,5,5,23,5,5,17,5,5,5,17,18,16,17,5,17,5,5,17,17,5,17,17,17,6,17,17,5,5,5,5,17
17,5,17,17,17,5,5,17,17,5,17,17,5,5,17,17,5,17,5,5,17,5,17,17,5,17,5,5,5,5,17,17,5,17,5,17,17,17,17,5,23,5,23,5,17,17,17,5,23,23,5,23,5,5,17,5,5,17,17,18,16,5,17,5,17,5,17,17,5,17,5,17,6,6,17,5,5,5,17,5
17,5,17,5,17,17,5,17,17,17,17,5,17,17,5,17,17,17,5,17,17,5,17,17,17,17,5,5,5,17,17,5,17,5,5,17,17,5,5,5,5,17,5,17,17,17,5,17,5,23,23,23,5,5,5,5,5,5,5,18,16,17,5,17,17,5,5,17,5,17,5,5,5,6,6,6,17,5,5,17
17,5,5,5,17,17,17,17,5,17,5,5,5,5,5,5,17,17,17,17,5,5,17,17,17,17,17,17,5,17,17,5,17,17,17,17,5,17,5,5,5,5,5,17,5,5,5,17,5,5,5,23,5,17,17,17,17,17,5,18,16,17,17,5,17,5,17,17,17,17,17,17,17,17,5,6,6,17,5,5
5,5,17,5,17,5,5,17,5,17,17,5,5,17,5,5,17,5,17,5,5,5,5,17,17,5,5,17,5,5,17,5,5,17,17,17,17,17,17,17,5,5,17,17,17,17,5,5,5,5,5,5,17,5,17,17,17,17,17,17,5,5,17,20,19,17,20,19,5,17,5,17,17,17,17,5,6,6,17,5
5,17,17,5,17,17,5,17,5,17,5,17,5,17,5,17,5,5,17,17,5,17,17,5,5,17,17,5,17,17,5,5,17,17,5,17,17,17,5,5,5,17,17,5,17,5,5,17,5,5,5,5,5,5,17,17,17,17,5,5,5,20,33,36,3,5,18,16,5,17,17,17,5,17,5,5,5,6,6,6
17,17,5,5,5,17,5,5,17,17,17,5,17,17,5,17,17,5,17,17,17,17,17,5,5,17,17,5,5,5,17,17,5,17,17,5,5,17,17,17,17,17,17,17,17,17,5,5,5,5,17,17,17,5,17,17,5,17,5,20,19,18,21,16,5,5,18,16,17,17,5,17,17,5,17,17,5,5,6,6
17,5,17,5,17,17,5,17,5,17,17,5,5,5,5,5,5,17,5,17,5,5,17,5,17,5,17,5,17,5,17,5,5,17,5,5,5,17,5,5,17,17,5,17,17,5,5,5,17,5,17,17,5,17,17,17,5,17,17,18,16,4,2,32,19,5,18,16,5,5,5,5,5,5,5,5,5,5,17,5
17,17,17,17,17,17,5,5,5,5,5,5,5,5,5,17,17,17,17,17,17,5,17,17,5,17,17,17,17,5,5,5,5,5,5,5,17,17,17,17,5,17,17,17,5,5,17,20,33,33,33,33,33,33,33,33,33,33,33,34,32,19,18,21,32,19,4,3,17,5,17,5,17,5,17,17,17,5,5,17
17,5,17,5,17,17,5,17,17,5,5,5,5,5,17,5,5,17,5,5,17,17,5,17,17,17,17,5,17,5,17,17,17,17,17,17,17,20,33,33,33,33,33,33,33,33,33,34,0,1,1,1,1,1,1,1,1,1,1,2,21,16,18,0,2,16,20,19,5,17,5,17,17,5,5,5,5,17,5,5
5,17,17,17,17,5,17,17,17,17,17,17,17,5,5,5,17,5,17,17,17,17,5,5,5,17,20,33,33,33,33,33,33,33,33,33,33,34,0,1,1,1,1,1,1,1,1,1,3,17,5,5,5,5,17,5,17,17,17,4,2,32,34,32,34,35,34,16,17,17,17,17,17,17,5,17,5,17,17,5
5,17,17,17,17,5,5,5,5,5,5,17,5,5,17,17,5,5,17,5,5,5,5,5,5,5,4,1,1,1,1,1,1,1,1,1,1,1,3,5,5,17,5,17,17,5,17,5,17,17,5,17,5,5,5,17,17,5,17,17,18,21,21,0,35,34,21,32,19,17,5,5,5,5,17,17,17,5,5,5
17,5,5,17,5,17,17,5,17,17,17,17,5,17,5,5,5,17,5,5,5,5,5,17,5,5,5,5,5,5,17,17,5,5,5,5,17,5,17,5,5,5,17,5,5,17,17,17,17,5,17,17,5,17,17,17,5,5,17,5,4,1,1,3,17,5,4,2,16,5,5,5,5,5,5,17,17,5,17,5
17,5,17,5,17,5,5,5,5,17,17,5,17,5,5,17,17,17,5,17,17,17,17,5,5,5,17,17,5,17,17,5,5,5,17,17,17,17,5,5,5,17,5,17,17,17,5,17,5,5,17,17,17,17,5,17,17,5,17,17,5,17,5,5,17,5,5,18,16,5,17,17,17,17,17,5,5,17,5,5
5,17,5,17,5,17,17,17,5,17,17,17,17,5,5,17,17,17,17,5,17,5,5,17,17,17,5,17,5,17,5,17,17,5,5,17,5,5,17,17,17,5,17,5,17,5,17,5,5,5,17,17,5,17,5,5,17,17,17,17,5,17,17,17,5,5,17,18,16,5,5,17,17,17,5,17,5,5,5,5
5,17,5,5,5,5,5,5,5,5,17,17,5,17,5,5,17,17,5,5,5,5,17,17,5,17,5,17,17,17,17,5,5,5,5,5,17,5,17,5,5,17,17,17,5,17,5,17,5,17,17,17,17,17,17,17,17,17,5,5,5,17,17,5,17,17,17,18,16,5,5,17,17,5,5,5,5,5,5,5
17,5,17,5,17,17,5,17,17,5,17,17,17,5,5,17,5,5,17,5,5,5,5,17,17,17,5,5,17,5,17,17,17,5,5,17,5,5,5,17,5,17,17,5,17,17,5,5,17,17,5,5,17,17,17,5,17,17,5,5,5,17,5,5,5,17,17,18,16,17,5,5,5,5,5,5,5,17,5,5
17,5,5,17,5,17,17,17,17,5,17,17,5,17,17,5,17,17,5,5,5,17,17,17,5,5,5,17,5,17,17,5,5,5,17,17,5,17,17,5,17,5,5,5,5,17,5,5,5,5,17,5,5,17,5,17,5,5,17,17,17,17,17,17,17,5,17,18,16,17,5,5,5,5,17,17,5,17,5,17
17,17,5,17,17,5,17,17,17,17,17,5,17,5,17,5,17,17,5,17,5,17,17,5,17,17,5,17,5,5,5,5,17,5,5,17,5,17,5,17,5,17,5,5,5,5,5,17,17,5,17,5,17,17,17,5,5,5,5,5,5,5,5,17,17,5,17,18,16,17,5,5,17,5,5,17,5,17,17,17
5,17,17,5,17,17,17,17,5,5,17,17,17,5,5,5,17,5,17,17,5,5,17,5,17,17,17,5,17,17,5,5,17,17,5,5,17,17,17,5,17,17,5,5,5,5,5,17,5,5,17,17,5,5,17,5,17,5,17,5,17,5,5,5,17,17,17,18,16,5,17,17,17,17,17,17,17,17,5,5
17,17,5,17,17,17,5,17,5,17,5,17,5,5,17,17,17,5,5,5,5,5,5,5,5,17,5,17,17,5,17,17,17,17,5,17,17,17,17,5,17,17,17,5,17,5,5,5,5,17,17,17,17,5,5,17,5,17,5,5,5,5,5,5,5,5,5,18,16,5,17,17,5,5,17,5,17,5,5,17
17,5,17,17,5,17,17,5,5,17,5,5,5,5,5,17,17,5,5,5,17,5,5,5,5,5,5,17,17,17,5,5,17,5,5,5,5,5,5,17,5,5,5,5,5,17,5,5,5,5,5,17,5,17,5,17,17,17,17,5,17,5,5,5,17,17,17,18,32,19,17,5,5,5,5,5,17,5,5,5
5,5,5,17,5,17,17,5,17,17,5,17,17,17,5,17,17,5,5,17,17,17,5,17,5,5,5,5,5,17,17,17,5,17,17,5,17,17,17,17,5,5,17,5,17,5,17,17,17,5,17,5,17,17,17,17,17,5,17,17,5,17,17,5,17,5,17,4,2,16,17,5,17,17,17,5,17,5,5,17
17,17,17,5,5,5,5,17,17,5,17,17,5,17,5,5,5,5,5,5,17,5,5,17,5,5,5,5,5,17,5,17,17,17,5,5,5,17,17,17,5,5,5,5,5,5,17,5,17,5,5,17,5,17,17,17,17,17,17,17,5,17,5,5,17,5,5,17,18,16,17,17,17,17,17,17,17,17,17,17
5,5,5,5,17,17,17,5,17,5,5,17,17,5,5,5,5,17,5,17,17,17,5,17,17,5,5,5,5,5,5,17,17,17,17,5,17,5,17,17,5,5,5,5,17,17,5,5,17,17,5,17,5,17,17,17,5,5,5,17,5,17,5,5,17,5,5,5,18,16,5,17,17,5,17,5,5,5,17,5
5,17,17,5,17,5,17,5,17,5,17,5,17,17,17,5,5,17,17,17,17,17,17,17,17,17,17,17,5,5,5,17,5,5,17,17,17,17,17,17,17,5,5,5,17,17,17,17,17,17,17,17,17,17,5,5,17,17,5,5,17,5,5,5,5,17,5,5,18,16,17,5,5,5,5,17,17,5,17,17
5,5,17,5,17,17,5,5,5,17,17,17,17,5,17,5,5,5,5,5,17,17,5,17,17,17,17,5,17,5,5,5,5,17,5,17,5,5,5,5,5,5,5,5,5,17,5,5,17,5,17,17,17,17,17,17,17,5,5,17,5,17,5,17,17,5,17,5,18,16,5,17,5,5,5,17,5,5,17,5
5,5,5,5,17,17,17,5,5,17,5,17,5,17,5,5,5,5,5,5,17,5,17,17,5,5,17,5,5,5,5,5,5,5,5,5,5,5,17,5,5,17,17,5,5,17,5,17,5,5,5,17,17,17,5,5,17,17,5,17,5,5,5,5,5,5,17,17,18,32,19,17,5,5,5,17,5,5,17,17
5,5,17,5,17,17,17,17,17,5,17,17,5,17,17,5,5,5,5,17,17,5,17,17,17,5,17,17,5,5,17,5,5,5,5,5,5,17,17,17,5,5,17,5,5,5,5,5,5,17,5,5,5,5,5,17,5,17,5,5,17,17,17,5,5,5,5,5,4,2,16,17,17,17,17,17,5,5,17,17
5,17,5,17,5,5,5,17,5,17,17,5,17,17,17,5,5,5,5,5,17,17,17,5,5,5,5,17,17,17,17,5,17,5,5,5,5,5,5,5,5,5,5,17,5,5,17,17,5,17,17,5,17,17,5,17,17,17,17,5,17,5,5,17,17,5,17,17,5,18,16,5,5,17,17,17,17,5,5,5
17,5,5,17,17,5,5,17,5,5,5,5,5,17,5,5,5,17,5,5,5,5,5,5,5,17,17,5,17,17,5,17,17,5,17,5,5,5,5,5,17,5,5,5,5,17,17,17,17,5,17,17,5,5,5,17,17,17,5,5,5,5,5,17,17,17,17,5,17,18,16,17,17,5,5,5,5,17,5,5
17,5,5,17,17,5,17,17,5,17,5,17,5,5,5,5,5,5,17,5,5,17,17,5,17,5,5,5,5,5,17,17,5,17,5,5,17,5,5,5,17,17,5,5,5,5,5,17,5,17,17,17,5,17,17,5,5,17,5,5,17,17,5,17,5,17,5,5,5,18,16,5,5,5,5,5,5,5,5,17
5,17,17,5,5,17,17,17,5,5,17,17,17,5,17,5,17,5,17,17,17,17,17,5,17,5,5,5,5,17,5,5,5,17,5,17,5,5,5,5,17,5,5,5,5,5,5,5,5,17,5,17,17,17,5,17,5,17,5,17,5,5,5,17,5,17,5,5,17,18,16,17,17,17,17,17,17,17,17,5
17,17,17,17,17,5,5,5,17,17,17,5,5,5,17,5,5,17,5,5,17,5,5,17,17,17,17,5,17,17,17,17,17,17,5,17,17,5,17,5,17,5,5,5,5,5,5,5,17,17,5,5,5,17,17,5,5,5,17,17,17,17,17,17,17,17,17,5,5,18,16,5,17,5,17,5,5,5,5,17
5,17,5,5,5,5,17,17,5,5,17,5,17,17,17,5,17,17,17,17,17,17,17,5,17,5,5,5,5,5,5,17,17,17,17,17,17,17,5,17,17,5,17,17,5,5,5,5,17,5,17,17,17,17,5,17,5,5,5,5,5,17,5,5,5,5,17,17,17,18,16,5,17,5,17,17,17,17,17,5
5,5,5,5,5,17,17,5,17,17,17,17,17,17,6,5,5,17,5,17,17,5,17,5,5,17,17,17,17,17,5,5,5,5,5,5,5,17,17,5,17,5,5,5,5,17,5,5,5,5,17,5,17,17,17,5,5,17,17,5,5,17,5,5,5,17,5,5,17,18,16,5,17,5,17,5,5,17,17,17
17,5,17,17,5,5,5,17,5,17,17,5,5,17,6,5,5,17,17,5,17,17,5,5,5,17,5,5,5,17,5,5,5,5,17,5,5,5,5,17,5,5,17,5,17,17,17,5,5,17,17,5,5,5,5,17,5,17,5,5,17,5,17,17,5,17,17,17,17,18,16,5,17,17,5,5,5,17,17,17
17,17,5,17,5,5,5,5,17,17,17,17,17,6,6,5,5,17,5,5,5,5,17,5,17,17,5,17,5,17,5,5,5,5,5,17,5,17,17,5,5,5,5,17,5,5,5,5,5,5,17,5,17,5,17,17,17,5,5,5,17,5,5,5,5,5,17,17,17,18,16,5,5,5,5,17,5,5,5,17
5,17,17,5,17,17,5,5,17,5,17,5,5,6,6,5,17,5,5,5,17,5,5,5,5,5,17,17,17,5,17,5,5,5,5,5,5,17,17,5,5,17,5,17,5,5,5,5,5,5,5,17,17,17,17,5,17,17,5,5,5,17,5,17,5,17,5,17,5,18,16,5,5,17,17,5,17,17,17,17
5,17,5,17,17,17,5,5,5,5,5,17,5,6,6,5,5,5,17,17,17,17,17,17,17,17,17,17,17,5,5,17,17,5,17,17,17,5,5,17,17,5,17,5,17,5,5,5,5,5,5,5,17,17,17,17,5,5,5,17,17,17,17,5,5,5,17,17,17,18,16,17,5,17,17,17,17,17,17,5
17,5,5,17,17,17,5,5,5,5,5,17,6,6,6,17,17,5,5,17,17,17,5,17,17,5,5,17,5,5,5,5,5,5,17,17,17,17,17,5,17,17,5,5,5,5,5,5,17,5,5,17,5,17,17,17,5,17,5,17,5,17,17,17,17,5,17,17,5,18,16,5,17,5,5,5,5,17,5,17
5,17,5,17,5,17,5,5,5,5,17,17,6,6,6,5,17,17,17,5,17,17,5,17,5,5,5,17,17,17,17,5,17,5,17,5,17,17,17,17,17,17,17,17,5,17,5,17,17,5,5,17,17,5,5,17,17,5,5,17,5,17,5,5,17,17,5,5,5,18,16,17,17,17,5,5,5,5,5,17
17,17,5,5,5,17,5,5,17,5,17,17,6,6,5,5,17,17,17,17,5,17,17,17,5,5,17,5,17,5,17,17,5,17,17,17,17,5,5,17,17,5,5,17,5,17,17,5,5,6,5,17,17,5,5,5,5,17,5,5,5,5,17,17,5,5,17,5,17,18,32,19,17,17,17,17,17,5,5,5
17,5,5,5,5,5,5,17,5,5,17,5,6,6,5,17,17,17,5,5,17,5,17,17,17,5,17,17,5,5,17,5,17,5,17,17,17,17,5,5,17,5,5,17,17,17,17,5,17,6,5,5,17,17,17,17,17,5,17,5,17,17,17,5,17,17,5,17,17,4,2,16,5,17,5,17,17,17,5,5
5,5,17,17,17,5,17,5,5,5,5,5,6,6,6,17,17,17,5,17,17,17,5,5,17,5,17,17,5,5,17,17,5,5,5,17,5,17,5,5,17,17,17,5,5,5,17,5,17,6,5,5,17,5,5,17,17,17,5,5,17,39,5,18,16,17,17,5,17,5,17,17,17,17,17,17,17,17,17,5
5,5,5,17,5,5,5,17,17,5,17,17,6,6,6,5,17,5,17,5,5,5,17,5,5,17,5,17,5,5,17,5,5,5,17,5,17,17,17,5,5,5,17,17,5,17,17,17,17,6,5,5,17,5,5,5,5,17,17,17,39,39,17,17,5,5,17,20,19,17,20,19,5,17,5,17,5,5,17,5
5,5,17,5,17,5,5,5,17,5,17,17,5,6,6,5,17,17,17,5,5,17,5,5,17,17,5,5,5,5,17,5,5,17,17,5,5,5,17,17,5,17,17,5,5,5,17,5,17,6,5,5,17,5,17,5,17,5,17,39,39,39,5,5,5,20,33,36,3,5,18,16,5,17,17,17,5,17,17,5
17,5,17,17,17,17,5,17,5,5,5,5,17,6,6,6,5,17,5,5,5,5,17,5,17,5,17,5,17,5,17,5,5,5,5,17,5,17,17,17,17,5,17,5,5,5,5,17,17,6,5,5,5,5,5,5,17,5,5,17,17,39,5,20,19,18,21,16,5,5,18,16,17,17,5,17,17,5,5,5
17,17,5,5,5,17,17,17,5,5,17,5,17,6,6,6,5,5,17,5,5,17,5,5,17,17,17,17,17,5,5,5,5,5,17,5,17,5,17,5,17,5,17,5,17,5,17,17,6,6,5,5,5,17,5,17,17,5,5,17,39,39,17,18,16,4,2,32,19,5,18,16,5,5,5,5,5,5,17,17
17,17,5,5,5,17,5,17,17,17,5,17,17,17,6,6,6,5,5,5,5,5,5,5,5,17,5,5,17,17,5,17,17,17,5,5,17,17,5,17,5,5,17,17,17,5,5,17,6,6,17,17,5,17,5,17,17,17,17,17,17,17,33,34,32,19,18,21,32,19,4,3,17,5,17,5,17,17,5,17
17,17,5,5,5,17,5,5,17,5,5,5,17,17,5,6,6,6,5,17,5,5,5,5,17,5,17,17,17,17,5,5,5,5,17,5,17,17,5,5,17,5,5,17,5,17,17,6,6,6,17,5,17,5,17,17,5,5,5,17,39,39,1,2,21,16,18,0,2,16,20,19,5,17,5,17,17,5,5,5
17,5,5,5,5,17,5,17,5,17,17,17,17,17,5,6,6,6,6,17,17,17,5,17,17,5,5,17,17,17,5,17,17,17,17,5,17,17,17,5,17,5,5,17,5,17,6,6,6,6,5,5,5,5,5,5,17,5,17,17,17,39,17,4,2,32,34,32,34,35,34,16,17,17,17,17,5,5,17,5
5,17,5,5,5,5,17,17,5,5,5,5,17,17,5,5,6,6,6,6,17,5,5,17,5,5,5,17,5,17,5,5,5,17,17,5,5,17,17,5,5,17,5,17,17,6,6,6,6,5,5,5,5,17,5,5,5,17,17,5,17,39,17,17,18,21,21,0,35,34,21,32,19,17,5,5,17,17,17,5
17,17,17,17,5,17,5,17,5,17,5,17,17,17,5,5,5,6,6,6,6,5,17,17,5,5,5,17,5,17,5,17,17,5,5,5,17,5,17,17,5,5,5,17,6,6,6,6,6,17,5,17,17,17,17,17,5,5,5,17,17,17,17,5,4,1,1,3,4,1,1,2,16,5,5,5,5,5,5,17
5,5,17,5,17,17,5,5,5,5,5,5,5,17,17,17,5,17,6,6,6,6,17,17,5,5,17,5,17,17,5,5,5,5,17,5,5,5,17,5,5,5,5,6,6,6,6,6,5,17,5,17,5,17,5,5,17,17,5,17,17,5,17,17,5,17,5,5,17,5,5,18,16,5,17,17,17,17,5,5
17,5,17,5,17,5,17,17,5,17,5,17,17,5,17,5,5,5,5,6,6,6,6,6,6,17,17,5,5,5,5,5,17,5,17,17,5,5,17,17,5,17,6,6,6,6,6,5,17,17,5,5,5,17,5,17,5,17,5,17,5,5,17,17,17,17,17,17,17,5,17,18,16,5,5,17,17,17,5,17
17,5,17,5,17,5,17,5,5,17,17,17,17,5,17,17,5,17,17,17,6,6,6,6,6,6,6,6,5,5,5,5,17,5,5,5,17,5,17,5,17,6,6,6,6,6,17,17,17,5,17,5,5,17,17,17,17,5,17,17,5,5,5,17,17,17,17,5,17,17,5,18,16,17,5,5,17,17,17,5
5,17,17,17,17,5,5,5,17,17,5,5,17,17,17,5,17,5,5,17,17,17,6,6,6,6,6,6,6,6,6,6,6,6,17,17,17,17,6,6,6,6,6,6,6,17,17,17,17,5,5,17,17,17,17,17,5,5,5,5,5,17,5,5,17,17,5,17,17,5,5,18,16,5,5,5,17,17,5,17
17,17,17,5,5,17,17,5,5,5,5,17,5,5,5,5,5,17,5,17,5,5,17,17,6,6,6,6,6,6,6,6,6,6,6,6,6,6,6,6,6,6,6,5,5,5,5,17,5,17,5,17,17,5,17,17,17,17,17,17,17,17,17,17,5,5,17,17,5,17,5,18,16,17,17,17,17,17,5,17
5,5,17,5,17,17,17,5,17,17,17,17,17,17,5,5,17,17,17,5,5,17,5,5,5,17,5,6,6,6,6,6,6,6,6,6,6,6,6,6,5,5,17,17,17,17,17,5,5,17,17,5,5,5,17,17,17,17,5,5,5,17,17,5,5,5,5,17,5,5,17,18,16,17,17,5,5,5,5,17
5,5,17,5,5,17,5,5,17,17,17,17,17,17,5,5,5,5,17,5,17,17,17,5,5,5,5,17,5,5,17,6,6,6,6,17,17,5,17,5,17,5,17,5,17,17,5,5,5,5,17,17,5,17,17,5,17,5,17,5,17,17,17,5,17,5,17,5,5,5,17,18,16,17,17,17,5,5,5,5
17,17,17,17,5,5,17,17,17,5,5,17,5,5,5,17,5,17,17,17,17,17,17,17,5,17,5,5,17,5,17,5,5,17,5,5,5,5,5,17,17,17,17,17,17,17,17,17,17,17,17,5,5,5,5,17,5,17,17,17,5,5,5,17,5,5,17,5,17,17,5,18,16,17,5,17,17,5,5,17
17,5,5,5,5,17,5,5,17,17,5,5,5,5,5,5,5,5,5,5,17,5,5,5,17,17,17,17,17,17,5,17,17,5,5,17,5,5,5,5,17,5,17,5,17,5,5,17,17,17,17,5,17,17,5,17,5,17,5,5,17,17,5,5,17,17,17,5,5,17,5,18,16,5,5,5,5,17,17,17
5,17,17,17,17,5,17,17,17,5,17,5,5,17,17,5,17,5,17,5,17,5,5,17,5,17,17,17,17,5,5,17,5,5,17,17,5,5,5,5,5,5,5,17,5,17,17,17,17,5,17,5,5,17,5,5,5,5,17,5,17,5,17,17,17,17,17,5,17,17,5,18,16,5,5,5,17,5,17,5
17,17,17,17,5,5,17,5,5,17,17,5,5,17,5,5,5,5,17,5,17,5,17,17,17,17,5,17,17,5,17,5,5,17,5,5,17,17,17,5,17,5,17,17,17,5,17,17,5,17,5,17,5,17,5,17,5,5,5,5,17,5,5,5,17,17,17,17,5,5,17,18,16,17,5,5,17,5,5,5
5,17,17,17,17,17,5,17,5,17,17,17,5,17,17,5,17,5,17,17,17,5,5,5,17,17,17,17,5,17,5,5,17,5,5,5,17,17,5,17,17,5,5,5,17,5,5,5,17,17,5,17,5,17,5,5,5,5,5,17,17,5,17,17,5,17,5,5,5,17,5,18,16,17,5,5,5,17,5,17
5,5,5,17,17,5,17,17,17,5,5,17,5,17,17,17,5,17,17,5,17,5,17,5,5,17,5,17,17,5,17,17,17,5,17,17,5,5,17,17,17,5,5,5,5,17,17,17,17,5,17,5,17,17,17,17,5,5,5,17,5,5,17,17,17,17,5,17,5,5,5,17,17,5,5,17,5,5,17,17
5,17,17,17,17,17,5,17,5,5,5,5,17,5,5,17,17,5,17,5,17,5,17,17,17,17,17,5,17,17,5,17,5,17,5,5,17,5,17,5,5,5,17,17,5,17,5,17,5,17,17,17,5,17,17,17,5,5,17,5,5,17,17,17,5,5,5,17,17,5,5,17,17,17,17,5,17,5,5,5
5,17,17,17,5,5,5,5,5,5,17,17,17,5,5,5,17,17,5,5,5,5,17,17,5,17,17,17,5,17,5,17,17,17,5,5,17,17,5,17,5,5,5,5,17,17,5,17,17,17,5,5,17,17,5,17,5,5,5,17,17,17,17,17,17,17,5,5,17,5,5,17,5,17,17,17,5,5,17,5
17,5,17,5,17,17,5,5,5,5,5,17,17,17,17,17,5,5,17,17,17,17,5,5,17,17,17,5,5,17,17,17,17,17,5,17,17,5,17,17,17,5,5,17,5,17,17,17,5,17,17,17,5,5,17,17,17,17,17,17,5,5,17,17,5,17,5,5,5,17,17,17,5,17,17,5,17,17,17,5
